110000000000000000000000000000000000000000000000011
110000000000000000000000000000000001000000000000011
001100000000000000000000000000000101000000000000000
001100000000000000000001100000011000000000000110000
000000000000000000000010001000011000000000000110000
000000000001100000000100000100011000000000000000000
000000000001100000000100010110000101000000000000000
000000000000000000000100000100000001000000000000000
000000000000000000000010001000000000000000000000000
000000000000000000000001100000000000000000000000000
000000000000000000000000000000000000000000000000000
000001000000000000000000000000000000000000000000000
000001000000000000000000000000000000000000000000000
000000000000000000000000000000000000000000000000000
000001000000000110000000000000000000000000000000000
000010100000000110000000000000000000000000000000000
000000000000011000000000000000000000000000000000000
000011100000011000000000000000000000000000000000000
000000000000000000000000000000000000000000000000000
000000000000011000000000000000000000000000000000000
000011100000011000000000000000000000000000000000000
000000000000000110000000000000000000000000000000000
000010100000000110000000000000000000000000000000000
000001000000000000000000000000000000000000000000000
000000000000000110000000000000000000000000000000000
000001000000000110000000000000000000000000000000010
000001000000011000000000000000000000000000000000101
000000000000011000000000000000000000000000000000010
